__8_________________
__8______________,,,
__8__________HHHHH__
__3__________H___H__
__8__________H___H__
__8__________HHDHH__
__88883888883388____
____________________
___________O________
__O_________________
_____BB__________O__
_____BB_____________
__O___B________,,,,,
_______________,,,,,
______O________,,,,,