BBBB************BBBB
********************
********************
********************
********BBBB********
********************
********************
********************
****************;;;;
****************....
****************....
********;;;;****....
********....****....
********....****....
;;;;;;;;;;;;;;;;;;;;
....................